                  ***
                 *****
            **  ******                     *
           *** ********                   ***
       *******  *******       *          ****
       *******   *****             ** ********** **    
 ***  * *****    *****        **  *   **************
 *************    ****       ****  * ******************
***************   **        ***************************
 *********** ***  *    **  *** ************************
 *********** ***           *** ******************** *
 *  *******  ****        ** * *******************  **
     ******* ***         ************************  *
      **********          ***********************
       *********        *********** ************* *
       *******          **  * ** ***************  *
       *******                * ** *********** * *
        ***  *           *** * **** ***********
         **   *         ************* ***  ****
          ***          ********* ***   *   **
            *          ********** *        **
             *****     ***********          * **  *
              *****     **********          ***    **
             ********      ******            *     *
             ********      *****                ** *
              ******        ****              *******
               *****        ****             ********
               ****         *** *            ********
               ***          *** *            **  ***   *
              ***           **                   **   *
              **                                      *
              **
              **
               *